

##################
# List of class names and instanciated objects
###################

Coms_Serial	KEYWORD1
Card	KEYWORD1
Menu	KEYWORD1
Internet	KEYWORD1
Fans	KEYWORD1
Encoder	KEYWORD1
Led_Strip	KEYWORD1
Current_Meter	KEYWORD1
Light_Sensor	KEYWORD1
Graphics	KEYWORD1
Host	KEYWORD1
HostNativeUSB	KEYWORD1
Card_LED


coms_serial	KEYWORD1
card	KEYWORD1
menu	KEYWORD1
internet	KEYWORD1
fans	KEYWORD1
led_strip	KEYWORD1
encoder	KEYWORD1
current_meter	KEYWORD1
light_sensor	KEYWORD1
graphics	KEYWORD1
host	KEYWORD1
nativeUsb	KEYWORD1
timers	KEYWORD1
card_led	KEYWORD1

############################
# List of high level functions
############################


init_serial	KEYWORD2
init_sd_cards	KEYWORD2
init_encoder	KEYWORD2
init_button	KEYWORD2
init_menu_tree	KEYWORD2
init_LDR	KEYWORD2
init_current_meter	KEYWORD2
init_cursor	KEYWORD2
init_fans	KEYWORD2
init_temp_sensors	KEYWORD2
init_led_strip	KEYWORD2
init_native_usb	KEYWORD2
init_serial	KEYWORD2



due_setup	KEYWORD2
due_loop	KEYWORD2
push_string_data	KEYWORD2
check_megas	KEYWORD2
get_readings	KEYWORD2
update_brightness	KEYWORD2
update_temperatures	KEYWORD2
set_fan_speed	KEYWORD2
led_strip_set_freq	KEYWORD2
handle_interupts	KEYWORD2
display_menu	KEYWORD2
check_serial	KEYWORD2
print_messages	KEYWORD2
check_for_sd_card	KEYWORD2
update_data_log	KEYWORD2



##################
# List of structs
###################


Frame	KEYWORD3
Led_Strip_Struct	KEYWORD3
Temp_sensor	KEYWORD3
Fan_Struct	KEYWORD3
Timers	KEYWORD3
Encoder_Struct	KEYWORD3
Button_Struct	KEYWORD3
LDR_Struct	KEYWORD3
Current_Meter_Struct	KEYWORD3
SD_Card	KEYWORD3
SD_Strings	KEYWORD3
Text	KEYWORD3
Text_cursor	KEYWORD3
Serial_Sub_Menu	KEYWORD3
Menu_tree_items	KEYWORD3
Menu_tree_menu_limits	KEYWORD3


##################
# List of pin names
###################


PIN_A	LITERAL1
PIN_B	LITERAL1
BUTTON_PIN	LITERAL1
LED_STRIP	LITERAL1
FAN_PIN	LITERAL1
LDR1	LITERAL1
LDR2	LITERAL1
CURRENT_METER_1	LITERAL1
CURRENT_METER_2	LITERAL1
TEMP1	LITERAL1
TEMP2	LITERAL1
TEMP3	LITERAL1
SD_LED_RED_PIN	LITERAL1
SD_LED_GREEN_PIN	LITERAL1
SD_LED_BLUE_PIN	LITERAL1
SD1_ENABLE	LITERAL1
SD2_ENABLE	LITERAL1
RX_PIN_1	LITERAL1
TX_PIN_1	LITERAL1
RX_PIN_2	LITERAL1
TX_PIN_2	LITERAL1
RX_PIN_3	LITERAL1
TX_PIN_3	LITERAL1
RX_PIN_4	LITERAL1
TX_PIN_4	LITERAL1


##################
# List of defined coms values
###################

PREFIX_CURRENT_1	LITERAL1
PREFIX_CURRENT_2	LITERAL1
PREFIX_TEMP_1	LITERAL1
PREFIX_TEMP_2	LITERAL1
PREFIX_TEMP_3	LITERAL1
PREFIX_LDR_1	LITERAL1
PREFIX_LDR_2	LITERAL1
PREFIX_FAN_SPEED	LITERAL1
PREFIX_FAN_MINIMUM_SPEED	LITERAL1
PREFIX_FAN_ENABLED	LITERAL1
PREFIX_LED_STRIP_BRIGHTNESS	LITERAL1
PREFIX_LED_STRIP_ENABLED	LITERAL1
PREFIX_SD1_DETECTED	LITERAL1
PREFIX_SD2_DETECTED	LITERAL1
PREFIX_EHTERNET_CONNECTED	LITERAL1
PREFIX_WIFI_CONNECTED	LITERAL1
PREFIX_SCREEN_BRIGHTNESS	LITERAL1
PREFIX_TEXT_SIZE_0	LITERAL1
PREFIX_TEXT_SIZE_1	LITERAL1
PREFIX_TEXT_SIZE_2	LITERAL1
PREFIX_TEXT_SIZE_3	LITERAL1
PREFIX_TEXT_SIZE_4	LITERAL1
PREFIX_TEXT_COLOUR_R_0	LITERAL1
PREFIX_TEXT_COLOUR_R_1	LITERAL1
PREFIX_TEXT_COLOUR_R_2	LITERAL1
PREFIX_TEXT_COLOUR_R_3	LITERAL1
PREFIX_TEXT_COLOUR_R_4	LITERAL1
PREFIX_TEXT_COLOUR_G_0	LITERAL1
PREFIX_TEXT_COLOUR_G_1	LITERAL1
PREFIX_TEXT_COLOUR_G_2	LITERAL1
PREFIX_TEXT_COLOUR_G_3	LITERAL1
PREFIX_TEXT_COLOUR_G_4	LITERAL1
PREFIX_TEXT_COLOUR_B_0	LITERAL1
PREFIX_TEXT_COLOUR_B_1	LITERAL1
PREFIX_TEXT_COLOUR_B_2	LITERAL1
PREFIX_TEXT_COLOUR_B_3	LITERAL1
PREFIX_TEXT_COLOUR_B_4	LITERAL1
PREFIX_TEXT_HUE_MSB_0	LITERAL1
PREFIX_TEXT_HUE_MSB_1	LITERAL1
PREFIX_TEXT_HUE_MSB_2	LITERAL1
PREFIX_TEXT_HUE_MSB_3	LITERAL1
PREFIX_TEXT_HUE_MSB_4	LITERAL1
PREFIX_TEXT_HUE_LSB_0	LITERAL1
PREFIX_TEXT_HUE_LSB_1	LITERAL1
PREFIX_TEXT_HUE_LSB_2	LITERAL1
PREFIX_TEXT_HUE_LSB_3	LITERAL1
PREFIX_TEXT_HUE_LSB_4	LITERAL1
PREFIX_TEXT_USE_HUE_0	LITERAL1
PREFIX_TEXT_USE_HUE_1	LITERAL1
PREFIX_TEXT_USE_HUE_2	LITERAL1
PREFIX_TEXT_USE_HUE_3	LITERAL1
PREFIX_TEXT_USE_HUE_4	LITERAL1
PREFIX_SCREEN_MODE	LITERAL1
PREFIX_SD_MOUNTED_1	LITERAL1
PREFIX_SD_MOUNTED_2	LITERAL1
PREFIX_TEXT_SCROLL_SPEED_X_0	LITERAL1
PREFIX_TEXT_SCROLL_SPEED_X_1	LITERAL1
PREFIX_TEXT_SCROLL_SPEED_X_2	LITERAL1
PREFIX_TEXT_SCROLL_SPEED_X_3	LITERAL1
PREFIX_TEXT_SCROLL_SPEED_X_4	LITERAL1
PREFIX_TEXT_SCROLL_SPEED_Y_0	LITERAL1
PREFIX_TEXT_SCROLL_SPEED_Y_1	LITERAL1
PREFIX_TEXT_SCROLL_SPEED_Y_2	LITERAL1
PREFIX_TEXT_SCROLL_SPEED_Y_3	LITERAL1
PREFIX_TEXT_SCROLL_SPEED_Y_4	LITERAL1
PREFIX_TEXT_OBJ_ENABLED_0	LITERAL1
PREFIX_TEXT_OBJ_ENABLED_1	LITERAL1
PREFIX_TEXT_OBJ_ENABLED_2	LITERAL1
PREFIX_TEXT_OBJ_ENABLED_3	LITERAL1
PREFIX_TEXT_OBJ_ENABLED_4	LITERAL1
PREFIX_TEXT_OBJ_SELECTED	LITERAL1


##################
# List of hardware restricted parameters
###################


DEFAULT_MENU_WIDTH	LITERAL1
TOTAL_WIDTH	LITERAL1
SINGLE_MATRIX_HEIGHT	LITERAL1
SINGLE_MATRIX_WIDTH	LITERAL1
NUM_SCREENS	LITERAL1
MAX_NUM_OF_TEXT_OBJECTS	LITERAL1


##################
# List of timer priorities
###################


SOFT_SERIAL_PRIORITY	LITERAL1
POS_FRAME_PRIORITY	LITERAL1
LED_STRIP_PRIORITY	LITERAL1
FAN_PRIORITY	LITERAL1


##################
# List of important Coms.h definitions
###################


COMS_SPEED	LITERAL1
RX_BUF_LENGTH	LITERAL1
TX_BUF_LENGTH	LITERAL1
HEADER_LENGTH	LITERAL1
TRAILER_LENGTH	LITERAL1
FRAME_TYPE_BYTE	LITERAL1
FRAME_LENGTH_BYTE	LITERAL1
ENDBYTE_CHARACTER	LITERAL1
FRAME_DATA_LENGTH	LITERAL1
FRAME_OVERHEAD	LITERAL1
MAX_TWEET_SIZE	LITERAL1
TEXT_FRAME_TYPE	LITERAL1
POS_FRAME_TYPE	LITERAL1
SENSOR_FRAME_TYPE	LITERAL1
MENU_FRAME_TYPE	LITERAL1
MEGA_RX_FRAME_LENGTH	LITERAL1


##################
# List of important Current_control.h definitions
###################


MAX_CURRENT_DRAW	LITERAL1
THIRTY_AMP	LITERAL1
TWENTY_AMP	LITERAL1
FIVE_AMP	LITERAL1


##################
# List of important fans.h definitions
###################


Temp1	KEYWORD1
Temp2	KEYWORD1
Temp3	KEYWORD1
FAN_TIMER	KEYWORD1
FAN_TIMER_INTERRUPT	LITERAL1
FAN_DEFAULT_SPEED	LITERAL1
FAN_TURN_ON_TEMPERATURE	LITERAL1
FAN_MAX_SPEED_TEMPERATURE	LITERAL1
MAX_OPERATING_TEMPERATURE	LITERAL1
MIN_OPERATING_TEMPERATURE	LITERAL1


##################
# List of important graphics.h definitions
###################


POS_TIMER	KEYWORD1
POS_TIMER_INTERRUPT	LITERAL1
ASCII_CHARACTER_BASIC_WIDTH	LITERAL1
ASCII_CHARACTER_BASIC_HEIGHT	LITERAL1
RED_MAX_VALUE	LITERAL1
GREEN_MAX_VALUE	LITERAL1
BLUE_MAX_VALUE	LITERAL1
HUE_MAX_VALUE	LITERAL1
HUE_MIN_VALUE	LITERAL1
DEFAULT_TEXT_SIZE	LITERAL1
DEFAULT_TEXT_RED_BRIGHTNESS	LITERAL1
DEFAULT_TEXT_GREEN_BRIGHTNESS	LITERAL1
DEFAULT_TEXT_BLUE_BRIGHTNESS	LITERAL1


##################
# List of important host.h definitions
###################


STOP_REPORT	LITERAL1
REPORT_FANS	LITERAL1
REPORT_TEMPS	LITERAL1
REPORT_LED_STRIP	LITERAL1
REPORT_MENU_TREE	LITERAL1
REPORT_LDRS	LITERAL1
REPORT_ENCODER	LITERAL1
REPORT_BUTTON	LITERAL1
REPORT_CURRENT_METER	LITERAL1
REPORT_TEXT	LITERAL1
REPORT_SERIAL	LITERAL1
REPORT_SD_CARD	LITERAL1
REPORT_LDR_CONFIG	LITERAL1

MAX_NUM_MENU_OPTIONS	LITERAL1
NUM_MENU_ITEMS	LITERAL1
NUM_MENU_ITEMS	LITERAL1
HEADER_PRINT_INCREMENT	LITERAL1


##################
# List of important led_strip.h definitions
###################


LED_STRIP_TIMER	KEYWORD1
LED_STRIP_TIMER_INTERRUPT	LITERAL1
LED_STRIP_DEFUALT_BRIGHTNESS	LITERAL1


##################
# List of important menu.h definitions
###################


STARTUP	LITERAL1
DEFAULT_MENU	LITERAL1
MAIN_MENU	LITERAL1
SCREEN_MODE_MENU	LITERAL1
BRIGHTNESS_MENU	LITERAL1
TEXT_SETTINGS_MENU	LITERAL1
FAN_SETTINGS_MENU	LITERAL1
INTERNET_CONFIG_MENU	LITERAL1
SD_CARD_MENU	LITERAL1
LED_STRIP_MENU	LITERAL1
TEXT_OBJ_SELECTION_MENU	LITERAL1
FAN_SPEED_MENU	LITERAL1
MIN_FAN_SPEED_MENU	LITERAL1
SD_FOLDERS_MENU	LITERAL1
LED_STRIP_BRIGHTNESS_MENU	LITERAL1
TEXT_SIZE_MENU	LITERAL1
TEXT_COLOUR_MENU	LITERAL1
SCROLL_SPEED_MENU	LITERAL1
TEXT_COLOUR_RED	LITERAL1
TEXT_COLOUR_GREEN	LITERAL1
TEXT_COLOUR_BLUE	LITERAL1
TEXT_COLOUR_HUE	LITERAL1
SCROLL_SPEED_MENU_X	LITERAL1
SCROLL_SPEED_MENU_Y	LITERAL1


##################
# List of important sd_cards.h definitions
###################

SdFile	KEYWORD1
file1	KEYWORD1
file2	KEYWORD1
SdFat	KEYWORD1
external_sd_card	KEYWORD1
internal_sd_card	KEYWORD1

EXTERNAL_SD_CARD_DIRECTORY_NAME	LITERAL1
INTERNAL_SD_CARD_DIRECTORY_NAME	LITERAL1
EXT_NETWORK_FILE	LITERAL1
INT_NETWORK_FILE	LITERAL1
EXT_STRING_FILE	LITERAL1
INT_STRING_FILE	LITERAL1
EXT_LOG_FILE	LITERAL1
INT_LOG_FILE	LITERAL1
EXT_CALIBRATION_FILE	LITERAL1
INT_CALIBRATION_FILE	LITERAL1
EXT_INSTRUCTION_FILE	LITERAL1
INT_INSTRUCTION_FILE	LITERAL1
EXT_BITMAP_FILE	LITERAL1
INT_BITMAP_FILE	LITERAL1
INTERNAL_CARD	LITERAL1
EXTERNAL_CARD	LITERAL1
RASP_PI	LITERAL1
STRING_FILE_COMMAND_STRING	LITERAL1
STRING_FILE_COMMAND_RED	LITERAL1
STRING_FILE_COMMAND_GREEN	LITERAL1
STRING_FILE_COMMAND_BLUE	LITERAL1
STRING_FILE_COMMAND_HUE	LITERAL1
STRING_FILE_COMMAND_SIZE	LITERAL1
STRING_FILE_COMMAND_X_SPEED	LITERAL1
STRING_FILE_COMMAND_Y_SPEED	LITERAL1
STRING_FILE_COMMAND_X_START_POS	LITERAL1
STRING_FILE_COMMAND_Y_START_POS	LITERAL1
STRING_FILE_COMMAND_X_END_POS	LITERAL1
STRING_FILE_COMMAND_Y_END_POS	LITERAL1
STRING_FILE_COMMAND_NUM_LOOPS_X	LITERAL1
STRING_FILE_COMMAND_NUM_LOOPS_Y	LITERAL1
STRING_FILE_COMMAND_DISP_TIME	LITERAL1
STRING_FILE_COMMAND_NEXT_FILE	LITERAL1
STRING_FILE_COMMAND_SCREEN_MODE	LITERAL1
CALIBRATION_FILE_COMMAND_FAN_ENABLED	LITERAL1
CALIBRATION_FILE_COMMAND_TEMP1_ENABLED	LITERAL1
CALIBRATION_FILE_COMMAND_TEMP2_ENABLED	LITERAL1
CALIBRATION_FILE_COMMAND_TEMP3_ENABLED	LITERAL1
CALIBRATION_FILE_COMMAND_STRIP_ENABLED	LITERAL1
CALIBRATION_FILE_COMMAND_CURRENT1_ENABLED	LITERAL1
CALIBRATION_FILE_COMMAND_CURRENT2_ENABLED	LITERAL1
CALIBRATION_FILE_COMMAND_LDR1_ENABLED	LITERAL1
CALIBRATION_FILE_COMMAND_LDR2_ENABLED	LITERAL1
CALIBRATION_FILE_COMMAND_ENCODER_ENABLED	LITERAL1
CALIBRATION_FILE_COMMAND_BUTTON_ENABLED	LITERAL1
CALIBRATION_FILE_COMMAND_SD_CARD1_ENABLED	LITERAL1
CALIBRATION_FILE_COMMAND_SD_CARD2_ENABLED	LITERAL1
CALIBRATION_FILE_COMMAND_FAN_MIN	LITERAL1
CALIBRATION_FILE_COMMAND_FAN_SPEED	LITERAL1
CALIBRATION_FILE_COMMAND_FAN_INCREMENT	LITERAL1
CALIBRATION_FILE_COMMAND_FAN_INTERVAL	LITERAL1
CALIBRATION_FILE_COMMAND_STRIP_BRIGHTNESS	LITERAL1
CALIBRATION_FILE_COMMAND_STRIP_MINUMUM	LITERAL1
CALIBRATION_FILE_COMMAND_STRIP_INCREMENT	LITERAL1
CALIBRATION_FILE_COMMAND_STRIP_INTERVAL	LITERAL1
CALIBRATION_FILE_COMMAND_ENCODER_SENSITIVITY	LITERAL1
CALIBRATION_FILE_COMMAND_LDR_CONFIG_MAX1	LITERAL1
CALIBRATION_FILE_COMMAND_LDR_CONFIG_MAX2	LITERAL1
CALIBRATION_FILE_COMMAND_LDR_CONFIG_MIN1	LITERAL1
CALIBRATION_FILE_COMMAND_LDR_CONFIG_MIN2	LITERAL1

